11111
10001
10001
1000111
1000001
1110001
  10001
  11111