11111110
10000010
10000010
10100010
100N0000
10101010
10000010
10010010
10010010
10010010
10000010
10000010
11111110
