1111111
1000001
1000001
100000111
1000N0001
111000001
  1000001
  1000001
  1111111

1111
1001
1001
1111