11111
10001
10001
1000111
1000001
1110N01
  10001
  11111

1111
1001
1001
1111